11111111
1N00P001
1000N001
1E000C01
11111111