11111111
1000P001
10000001
1E000C01
11111111