1111111111111111111111111111111111111111111111111111111111111111
1P00000000000000000000000000000000000000000000CC00000000E0000001
1000000000000000000000000000000000000000000000CC0000000000000001
1000000000000000000000000000000000000000000000CC0000000000000001
1000000000000000000000000000000000000000000000CC0000000000000001
1000000000000000000000000000000000000000000000CC0000000000000001
1000000000000000000000000000000000000000000000CC0000000000000001
1000000000000000000000000000000000000000000000CC0000000000000001
1000000000000000000000000000000000000000000000CC0000000000000001
1000000000000000000000000000000000000000000000CC0000000000000001
1000000000000000000000000000000000000000000000CC0000000000000001
1000000000000000000000000000000000000000000000CC0000000000000001
1000000000000000000000000000000000000000000000CC0000000000000001
1000000000000000000000000000000000000000000000CC0000000000000001
1000000000000000000000000000000000000000000000CC0000000000000001
1000000000000000000000000000000000000000000000CC0000000000000001
1000000000000000000000000000000000000000000000CC0000000000000001
1000000000000000000000000000000000000000000000CC0000000000000001
1000000000000000000000000000000000000000000000CC0000000000000001
1000000000000000000000000000000000000000000000CC0000000000000001
1000000000000000000000000000000000000000000000CC0000000000000001
1000000000000000000000000000000000000000000000CC0000000000000001
1000000000000000000000000000000000000000000000CC0000000000000001
1000000000000000000000000000000000000000000000CC0000000000000001
1000000000000000000000000000000000000000000000CC0000000000000001
1000000000000000000000000000000000000000000000CC0000000000000001
1000000000000000000000000000000000000000000000CC0000000000000001
1000000000000000000000000000000000000000000000CC0000000000000001
1000000000000000000000000000000000000000000000CC0000000000000001
1000000000000000000000000000000000000000000000CC0000000000000001
1000000000000000000000000000000000000000000000CC0000000000000001
1000000000000000000000000000000000000000000000CC0000000000000001
1000000000000000000000000000000000000000000000CC0000000000000001
1000000000000000000000000000000000000000000000000000000000000001
1111111111111111111111111111111111111111111111111111111111111111