11111111111111
1P000000000CC1
10000C00000E11
100000000000C1
1000000C0000C1
1000000C0000C1
100000000000C1
10C0000000C0C1
100000C00000C1
10000000C000C1
11111111111111
