11111111
1N00P001
10000001
1E000C01
11111111