111111111111111
1P00000000000E1
101111111111101
10C000000000001
111101111111101
1C00000000000C1
111111111111111