11111111
10P0CE11
10000001
11111111