11111111111111111111111111111111111111111111111111111111111111111
100000000000000000000000000000000000000000000000000000P000000CE11
11111111111111111111111111111111111111111111111111111111111111111