1111111
1000001
10P0001
100C001
1E0C001
1111111